14 16
5 3 3 3 3 3 3 3 13 10 3 3 3 3 3 3
2 10 3 3 3 3 3 3 6 9 3 3 3 3 3 3
3 2 10 3 3 3 3 3 2 10 3 3 3 3 3 3
6 8 9 3 3 3 6 10 6 9 3 3 3 3 3 3
5 3 3 3 3 3 5 5 2 10 3 3 3 3 3 3
5 3 6 10 3 6 9 2 15 2 10 3 3 3 3 3
2 10 5 2 8 11 10 3 3 6 9 3 3 3 3 3
3 2 9 6 8 9 2 8 8 9 3 3 3 3 3 3
14 6 8 9 3 3 3 3 3 3 3 3 3 3 3 3
5 2 8 10 3 3 3 3 3 3 3 3 3 3 3 3
2 8 10 5 3 3 3 3 3 3 3 3 3 3 3 3
3 3 5 5 3 3 3 3 3 3 3 3 3 3 3 3
3 3 2 9 3 3 3 3 3 3 3 3 3 3 3 3
3 3 3 3 3 3 3 3 3 3 3 3 3 3 3 3