5 3 6 8 8 10 3 3 3 3 3 3 3 3 3 3
2 8 9 3 6 9 3 3 3 3 3 3 3 3 3 3
3 3 3 6 9 3 3 3 3 3 3 3 3 3 3 3
3 3 3 5 3 6 8 10 3 3 3 3 6 12 3 3
3 3 3 2 10 5 3 5 6 8 8 8 9 3 3 3
3 3 3 6 9 2 10 2 9 6 10 3 3 3 3 3
3 3 3 2 7 7 9 3 6 9 5 3 3 3 3 3
3 3 3 3 5 2 8 8 9 3 5 3 3 12 3 3
3 3 3 3 2 8 8 10 3 3 12 3 3 5 3 3
3 3 3 3 3 3 3 2 8 8 10 3 3 5 3 3
3 3 3 3 3 3 3 3 3 3 5 3 6 9 3 3
3 3 3 3 3 3 3 3 3 3 2 8 9 3 3 3
