12 16
5 6 8 10 3 3 3 3 3 3 3 3 3 3 3 3
5 5 3 2 8 8 10 3 3 3 3 3 3 3 3 3
2 9 3 3 3 3 5 3 3 6 10 3 3 3 3 3
3 3 3 3 3 3 2 8 8 9 5 3 3 3 3 3
3 3 3 3 6 8 10 3 6 8 11 10 3 3 3 3
3 3 3 6 9 3 5 6 9 12 9 5 3 3 3 3
3 3 3 2 10 3 2 9 3 6 8 9 6 8 8 10
3 3 3 3 2 10 3 3 3 5 6 8 9 3 3 5
3 3 12 8 8 9 3 3 3 2 9 3 3 3 6 9
3 3 3 3 3 3 3 3 3 3 3 3 3 12 9 3
3 3 3 3 3 3 3 3 3 3 3 3 3 3 3 3
3 3 3 3 3 3 3 3 3 3 3 3 3 3 3 3
