12 20
8 10 3 3 6 8 10 6 10 3 3 3 3 3 3 3 3 3 3 3
6 9 6 8 9 14 2 9 5 3 3 3 3 3 3 3 3 3 3 3
5 6 9 3 3 5 3 6 11 8 10 3 3 3 3 3 3 3 3 3
2 9 3 3 3 2 8 9 5 13 9 3 3 3 3 3 3 3 3 3
3 3 3 3 3 3 3 3 2 8 10 3 3 3 3 6 8 10 14 3
3 3 3 3 3 3 3 3 3 3 2 10 6 10 6 9 3 2 9 3
3 3 3 3 3 3 3 3 3 3 3 2 9 2 9 3 3 3 3 3
3 3 3 3 3 3 3 3 3 3 3 3 3 3 3 3 3 3 3 3
3 3 3 3 3 3 3 3 3 3 3 3 3 3 3 3 3 3 3 3
3 3 3 3 3 3 3 3 3 3 3 3 3 3 3 3 3 3 3 3
3 3 3 3 3 3 3 3 3 3 3 3 3 3 3 3 3 3 3 3
3 3 3 3 3 3 3 3 3 3 3 3 3 3 3 3 3 3 3 3
