12 18
5 3 6 8 8 10 6 8 8 8 8 10 3 6 8 8 15 3
5 3 2 8 10 5 0 8 7 10 3 2 10 5 3 3 3 3
2 8 10 6 9 2 9 3 5 2 10 3 2 9 3 3 3 3
3 3 2 9 6 8 10 3 5 3 5 6 10 3 3 3 3 3
3 3 3 3 2 10 12 3 5 3 2 9 5 3 3 3 3 3
3 3 3 3 3 2 8 8 9 3 3 3 2 15 3 3 3 3
3 3 3 3 3 3 3 3 3 3 3 3 3 3 3 3 3 3
3 3 3 3 3 3 3 3 3 3 3 3 3 3 3 3 3 3
3 3 3 3 3 3 3 3 3 3 3 3 3 3 3 3 3 3
3 3 3 3 3 3 3 3 3 3 3 3 3 3 3 3 3 3
3 3 3 3 3 3 3 3 3 3 3 3 3 3 3 3 3 3
3 3 3 3 3 3 3 3 3 3 3 3 3 3 3 3 3 3
