12 19
5 3 6 8 10 3 6 8 8 10 3 3 3 3 3 3 3 3 3
2 8 9 3 2 8 9 6 8 9 3 3 3 3 3 3 3 3 3
6 8 8 10 6 10 3 2 7 8 10 3 3 3 3 3 3 3 3
5 6 10 2 9 2 8 8 1 3 2 10 3 3 3 3 3 3 3
2 9 12 6 8 8 8 8 9 3 6 9 3 3 3 3 3 3 3
3 3 3 5 3 3 3 3 3 3 5 6 10 6 8 8 8 12 3
6 8 12 5 3 3 3 3 3 3 2 9 2 9 3 3 3 3 3
5 3 6 9 3 3 3 3 3 3 3 3 3 3 3 3 3 3 3
2 8 9 3 3 3 3 3 3 3 3 3 3 3 3 3 3 3 3
3 3 3 3 3 3 3 3 3 3 3 3 3 3 3 3 3 3 3
3 3 3 3 3 3 3 3 3 3 3 3 3 3 3 3 3 3 3
3 3 3 3 3 3 3 3 3 3 3 3 3 3 3 3 3 3 3
