15 16
8 10 3 6 10 3 3 3 3 3 3 3 3 3 3 3
3 2 8 9 5 3 3 3 3 3 3 3 3 3 3 3
6 8 10 3 2 10 3 3 3 3 3 3 3 3 3 3
5 6 9 6 8 9 3 3 3 3 3 3 3 3 3 3
12 2 10 5 3 3 3 3 3 3 3 3 3 3 3 3
6 8 9 2 10 3 3 3 3 3 3 3 3 3 3 3
5 3 6 7 9 3 3 3 3 3 3 3 3 3 3 3
2 8 1 2 8 10 3 3 3 3 3 3 3 3 3 3
3 6 9 6 10 5 3 3 3 3 3 3 3 3 3 3
6 9 6 9 2 9 3 3 3 3 3 3 3 3 3 3
12 6 9 3 3 3 3 3 3 3 3 3 3 3 3 3
6 9 3 3 3 3 3 3 3 3 3 3 3 3 3 3
2 10 3 3 3 3 3 3 3 3 3 3 3 3 3 3
3 12 3 3 3 3 3 3 3 3 3 3 3 3 3 3
3 3 3 3 3 3 3 3 3 3 3 3 3 3 3 3
