12 16
5 6 8 8 8 8 8 10 3 3 3 3 3 3 3 3
2 9 3 3 3 6 10 2 8 8 10 3 3 3 3 3
3 3 3 3 6 9 2 10 6 8 9 3 3 3 3 3
3 3 3 3 5 3 3 5 5 3 3 3 3 3 3 3
3 3 3 3 2 10 3 5 5 3 3 3 3 3 3 3
3 3 3 13 8 9 6 4 9 3 3 3 3 3 3 3
3 3 3 6 8 8 4 8 8 10 3 3 3 3 3 3
3 3 3 5 3 3 6 10 3 2 8 10 3 3 3 3
3 3 3 5 3 3 5 2 8 8 8 9 3 3 3 3
6 8 10 2 10 3 5 3 3 3 3 3 3 3 3 3
2 10 5 6 9 3 2 10 3 3 3 3 3 3 3 3
3 12 2 9 3 3 3 12 3 3 3 3 3 3 3 3
