19 16
 05 06 10 03 03 03 03 03 03 03 03 03 03 03 03 03
 02 09 05 03 03 03 03 03 03 03 03 03 03 03 03 03
 06 08 09 03 03 03 03 03 03 03 03 03 03 03 03 03
 02 08 10 03 03 03 03 03 03 03 03 03 03 03 03 03
 03 03 02 10 03 03 03 03 03 03 03 03 03 03 03 03
 06 10 03 05 03 03 03 03 03 03 03 03 03 03 03 03
 05 02 15 05 03 03 03 03 03 03 03 03 03 03 03 03
 05 03 03 05 03 03 03 03 03 03 03 03 03 03 03 03
 02 10 03 05 06 08 10 06 10 03 03 03 03 03 03 03
 03 02 10 05 05 03 02 09 02 08 08 08 10 03 03 03
 06 08 09 05 05 03 03 03 03 03 03 06 09 03 03 03
 02 08 08 11 09 03 03 03 03 13 08 09 03 03 03 03
 03 03 03 02 08 08 08 08 10 03 03 03 03 03 03 03
 03 03 03 03 03 03 03 03 05 03 03 03 03 03 03 03
 03 03 03 03 03 03 03 06 09 03 03 03 03 03 03 03
 03 03 03 03 03 03 03 05 06 08 10 03 03 03 03 03
 03 03 03 03 03 03 03 05 02 10 12 03 03 03 03 03
 03 03 03 03 03 03 03 02 08 09 03 03 03 03 03 03
 03 03 03 03 03 03 03 03 03 03 03 03 03 03 03 03
