19 16
 08 10 03 03 03 03 03 03 03 03 03 06 15 03 03 03
 03 05 03 03 03 03 03 03 03 03 03 05 03 03 03 03
 03 05 03 03 03 03 06 10 06 10 03 05 03 03 03 03
 03 05 03 03 03 03 05 02 09 02 08 09 03 03 03 03
 03 05 03 03 03 03 02 10 03 03 13 10 03 03 03 03
 06 09 06 10 03 03 03 05 03 03 03 05 03 03 03 03
 02 08 09 02 08 10 06 09 03 06 08 09 03 03 03 03
 03 03 03 03 06 09 05 03 03 02 10 03 03 03 03 03
 03 03 03 03 02 08 11 08 10 06 09 03 03 03 03 03
 03 03 03 03 06 08 09 06 09 05 03 03 03 03 03 03
 03 03 03 03 05 03 03 02 10 05 03 03 03 03 03 03
 03 03 03 03 02 08 10 03 02 09 03 03 03 03 03 03
 03 03 03 03 03 03 05 03 03 03 03 03 03 03 03 03
 03 03 03 03 03 03 02 08 08 10 03 03 03 03 03 03
 03 03 03 03 03 03 03 03 03 05 03 03 03 03 03 03
 03 03 03 03 03 03 03 03 06 09 03 03 03 03 03 03
 03 03 03 03 03 03 03 03 02 10 03 03 03 03 03 03
 03 03 03 03 03 03 03 13 08 09 03 03 03 03 03 03
 03 03 03 03 03 03 03 03 03 03 03 03 03 03 03 03
