20 16
 05 03 03 03 03 03 03 03 03 03 06 10 03 03 03 03
 05 03 03 03 03 03 03 03 03 03 05 02 10 03 03 03
 05 06 10 03 03 03 03 03 06 08 09 06 09 03 03 03
 02 09 05 03 03 03 06 08 09 03 03 05 03 03 03 03
 06 08 09 06 08 10 05 03 03 03 13 09 03 03 03 03
 02 08 08 09 06 09 05 03 03 03 03 03 03 03 03 03
 03 06 10 06 11 08 09 03 03 03 03 03 03 03 03 03
 06 09 02 09 02 10 03 03 03 03 03 03 03 03 03 03
 05 03 03 03 03 02 10 03 03 03 03 03 03 03 03 03
 05 03 03 03 03 03 02 10 03 03 03 03 03 03 03 03
 05 03 03 03 03 03 06 09 03 03 03 03 03 03 03 03
 05 03 03 03 03 03 02 10 03 03 03 03 03 03 03 03
 02 08 10 06 10 03 03 05 03 03 03 03 03 03 03 03
 03 03 02 09 02 15 03 05 03 03 03 03 03 03 03 03
 03 03 03 03 03 03 03 05 03 03 03 03 03 03 03 03
 03 03 03 03 03 03 03 05 03 03 03 03 03 03 03 03
 03 03 03 03 03 03 06 09 03 03 03 03 03 03 03 03
 03 03 03 03 03 03 02 10 03 03 03 03 03 03 03 03
 03 03 03 03 03 03 13 09 03 03 03 03 03 03 03 03
 03 03 03 03 03 03 03 03 03 03 03 03 03 03 03 03
