16 16
8 8 10 3 3 3 3 3 3 3 3 3 3 3 3 3
6 8 9 3 3 3 3 3 3 3 3 3 3 3 3 3
5 3 3 3 3 3 3 3 3 3 3 3 3 3 3 3
5 3 6 8 10 3 3 3 3 3 3 3 3 3 3 3
2 8 9 3 5 3 3 3 3 3 3 3 3 3 3 3
3 6 12 6 9 3 3 3 3 3 3 3 3 3 3 3
3 2 10 5 3 3 3 3 3 3 3 3 3 3 3 3
6 8 11 9 3 3 3 3 3 3 3 3 3 3 3 3
2 10 2 10 3 3 3 3 3 3 3 3 3 3 3 3
3 5 12 9 3 3 3 3 3 3 3 3 3 3 3 3
3 5 6 10 3 3 3 3 3 3 3 3 3 3 3 3
3 2 9 5 3 3 3 3 3 3 3 3 3 3 3 3
3 3 3 5 3 3 3 3 3 3 3 3 3 3 3 3
3 3 3 5 6 8 8 12 3 3 3 3 3 3 3 3
3 3 3 2 9 3 3 3 3 3 3 3 3 3 3 3
3 3 3 3 3 3 3 3 3 3 3 3 3 3 3 3
