12 23
 08 08 10 06 15 06 10 06 08 07 08 08 10 03 03 03 03 03 03 03 03 03 03
 03 06 09 02 08 09 02 04 10 02 08 10 02 08 10 03 03 03 03 03 03 03 03
 06 09 06 08 08 08 08 08 09 03 06 09 03 03 05 03 03 03 03 03 03 03 03
 05 06 09 03 03 03 03 03 03 03 05 03 03 03 02 08 08 08 08 10 03 03 03
 02 09 03 03 03 03 03 03 03 06 09 03 03 03 03 03 03 03 03 02 10 03 03
 03 03 03 03 03 03 03 03 03 02 10 14 03 03 03 03 03 03 03 03 02 15 03
 03 03 03 03 03 03 03 03 03 06 09 05 03 03 03 03 03 03 03 03 03 03 03
 03 03 03 03 03 03 03 03 03 02 08 09 03 03 03 03 03 03 03 03 03 03 03
 03 03 03 03 03 03 03 03 03 03 03 03 03 03 03 03 03 03 03 03 03 03 03
 03 03 03 03 03 03 03 03 03 03 03 03 03 03 03 03 03 03 03 03 03 03 03
 03 03 03 03 03 03 03 03 03 03 03 03 03 03 03 03 03 03 03 03 03 03 03
 03 03 03 03 03 03 03 03 03 03 03 03 03 03 03 03 03 03 03 03 03 03 03
