14 16
 08 08 10 06 08 10 03 06 08 08 07 08 08 10 03 03
 03 03 02 09 03 05 03 05 06 08 01 06 08 09 03 03
 03 03 03 03 03 02 10 05 05 03 05 02 08 10 03 03
 03 03 03 03 03 03 02 09 05 06 09 03 03 05 03 03
 03 03 03 03 03 03 03 03 05 05 03 06 15 05 03 03
 03 03 03 03 03 06 08 08 09 05 03 02 10 05 03 03
 03 03 03 03 03 02 08 10 03 05 03 03 02 09 03 03
 03 03 03 03 03 06 08 09 03 05 03 03 03 03 03 03
 03 03 03 03 03 02 15 03 03 05 03 03 03 03 03 03
 03 03 03 03 03 03 03 03 03 02 08 10 03 03 03 03
 03 03 03 03 03 03 03 03 03 03 03 02 08 10 03 03
 03 03 03 03 03 03 03 03 03 03 03 03 03 05 03 03
 03 03 03 03 03 03 03 03 03 03 03 03 13 09 03 03
 03 03 03 03 03 03 03 03 03 03 03 03 03 03 03 03
