12 16
8 10 6 7 8 8 8 8 8 8 10 3 13 8 10 3
3 5 5 2 8 8 7 10 3 3 2 10 3 6 9 3
6 9 2 10 6 8 9 2 10 3 3 5 6 9 3 3
5 6 8 9 5 6 10 3 2 8 10 2 9 3 3 3
5 5 3 3 2 9 5 3 3 3 5 3 6 8 15 3
5 2 10 3 3 6 9 3 3 3 2 8 9 3 3 3
2 8 9 3 3 5 3 3 3 3 3 3 3 3 3 3
3 3 3 3 3 5 3 3 3 3 3 3 3 3 3 3
3 3 3 3 3 2 15 3 3 3 3 3 3 3 3 3
3 3 3 3 3 3 3 3 3 3 3 3 3 3 3 3
3 3 3 3 3 3 3 3 3 3 3 3 3 3 3 3
3 3 3 3 3 3 3 3 3 3 3 3 3 3 3 3