12 16 02 10 03 05 03 03 05 03 03 05 03 03 03 03 05 03 
03 05 03 05 03 03 05 03 03 05 03 03 03 03 05 03 
03 05 06 09 03 03 05 03 03 05 03 03 03 06 09 03 
03 02 04 08 08 08 11 08 08 11 08 08 08 01 03 03
03 03 03 03 03 03 02 10 03 05 03 03 03 02 08 08 
03 03 03 03 03 03 03 05 03 05 03 03 03 03 03 03 
03 03 03 03 03 03 03 05 06 09 03 03 03 03 03 03 
03 03 03 03 03 03 03 02 04 08 08 08 10 03 06 08 
03 03 03 03 03 03 03 03 03 03 03 03 05 03 05 03 
03 03 03 03 03 03 03 03 03 03 03 03 05 06 09 03 
03 03 03 03 03 03 03 03 03 03 03 03 02 04 08 08 
03 03 03 03 03 03 03 03 03 03 03 03 03 03 03 03  