14 16
 05 03 03 03 03 03 03 03 03 03 03 03 03 03 03 03
 05 03 03 03 03 03 03 03 03 03 03 03 03 03 03 03
 05 03 03 03 03 03 03 03 03 03 03 03 03 03 03 03
 05 03 03 03 03 03 03 03 03 03 03 03 03 03 03 03
 02 10 03 03 03 03 03 03 03 03 03 03 03 03 03 03
 03 05 03 03 03 03 03 03 03 03 03 03 03 03 03 03
 03 02 10 03 03 03 03 03 03 06 10 03 03 03 03 03
 03 03 02 08 08 08 10 03 03 12 02 08 10 03 03 03
 06 08 08 08 10 03 05 03 03 03 03 06 09 03 03 03
 02 08 10 03 05 06 09 03 03 03 03 02 10 03 03 03
 03 03 05 06 09 02 10 03 03 06 08 15 05 03 03 03
 03 13 09 05 06 08 11 08 08 09 03 06 09 03 03 03
 03 03 03 02 09 03 02 08 08 08 08 09 03 03 03 03
 03 03 03 03 03 03 03 03 03 03 03 03 03 03 03 03
