16 16
8 10 3 3 3 3 3 3 3 3 3 3 3 3 3 3
3 5 3 3 3 3 3 3 3 3 3 3 3 3 3 3
6 9 3 3 3 3 3 3 3 3 3 3 3 3 3 3
2 8 8 10 3 3 3 3 3 3 3 3 3 3 3 3
3 6 10 5 3 3 3 3 3 3 3 3 3 3 3 3
3 5 2 9 3 3 3 6 10 3 3 3 3 3 3 3
6 9 13 10 3 3 6 9 5 3 3 3 3 3 3 3
2 7 8 9 6 8 9 6 9 3 3 3 3 3 3 3
6 4 8 8 9 3 3 2 10 3 3 3 3 3 3 3
2 10 3 3 3 3 3 13 9 3 3 3 3 3 3 3
3 2 10 3 3 3 3 3 3 3 3 3 3 3 3 3
3 3 2 10 3 3 3 3 3 3 3 3 3 3 3 3
6 8 10 5 3 3 3 3 3 3 3 3 3 3 3 3
5 3 5 5 3 3 3 3 3 3 3 3 3 3 3 3
12 3 2 9 3 3 3 3 3 3 3 3 3 3 3 3
3 3 3 3 3 3 3 3 3 3 3 3 3 3 3 3