17 16
 05 06 10 03 03 03 03 03 03 03 03 03 03 03 03 03
 02 09 05 03 03 03 03 03 03 03 03 03 03 03 03 03
 03 03 05 03 03 03 03 03 03 03 03 03 03 03 03 03
 03 06 09 03 03 03 03 03 03 03 03 03 03 03 03 03
 03 05 03 03 03 03 03 03 03 03 03 03 03 03 03 03
 03 05 03 03 06 08 10 03 03 03 03 03 03 03 03 03
 06 09 03 03 05 03 12 03 03 03 03 03 03 03 03 03
 05 03 03 06 09 03 03 14 03 03 03 03 03 03 03 03
 05 06 08 09 03 03 03 05 03 03 03 03 03 03 03 03
 05 05 03 03 06 08 08 09 03 03 03 03 03 03 03 03
 05 05 03 03 05 03 03 03 03 03 03 03 03 03 03 03
 00 04 10 06 09 03 03 03 03 03 03 03 03 03 03 03
 05 03 02 09 03 03 03 03 03 03 03 03 03 03 03 03
 05 03 03 06 08 10 03 03 03 03 03 03 03 03 03 03
 05 03 06 09 13 09 03 03 03 03 03 03 03 03 03 03
 02 08 09 03 03 03 03 03 03 03 03 03 03 03 03 03
 03 03 03 03 03 03 03 03 03 03 03 03 03 03 03 03
